3;3;3;3;3;3;3;3;3;3;3;3;3;3;3;3;3;3;3;3;3;3;3;3;3;3;3;3;3;3;3;3;3;3;3;3;3;3;3;3;3;3;3;3;3;3;3;3;3;3;3;3;3;3;3;3;3;3;3;3;3;3;3;3;3;3;3
3;3;2;2;3;3;3;3;3;3;3;3;2;2;2;2;2;2;3;3;3;3;3;3;3;3;3;3;3;3;2;2;2;2;2;2;2;2;2;2;2;2;2;2;2;2;2;2;2;3;2;2;2;2;3;2;2;2;2;2;2;2;2;2;3;3;3
3;2;2;2;2;3;3;3;3;3;3;2;2;2;2;2;2;2;2;3;3;3;3;3;3;3;3;3;3;2;2;2;2;2;2;2;2;2;2;2;2;2;2;2;2;2;2;2;2;2;2;2;2;2;3;2;2;2;2;2;2;2;2;3;3;3;3
3;2;2;2;2;2;3;3;3;3;2;2;2;2;2;2;2;2;2;2;2;2;3;3;3;3;3;3;2;2;2;2;2;2;2;2;2;2;2;2;2;2;2;2;2;2;2;2;2;2;2;3;2;2;3;3;2;2;2;2;2;2;2;3;3;3;3
3;2;2;2;2;2;2;3;3;2;2;2;2;2;2;2;2;2;2;2;2;2;2;3;3;3;3;3;3;2;2;2;2;2;2;2;2;2;2;2;2;2;2;2;2;2;2;2;2;2;3;3;2;2;22;3;3;3;2;2;2;2;2;2;22;2;3
3;3;2;2;2;2;2;2;3;2;2;2;2;2;3;2;2;2;2;2;2;2;2;2;3;3;3;3;3;3;2;2;2;2;2;2;2;2;2;2;2;2;2;2;2;2;2;2;3;3;3;3;2;2;2;3;3;3;2;2;2;2;2;2;2;2;3
3;3;2;2;2;2;2;2;2;2;2;2;2;3;3;3;2;2;2;2;2;2;2;2;3;3;3;2;3;3;2;2;2;2;2;2;2;2;2;2;2;2;2;2;2;2;2;3;3;3;3;3;2;2;2;3;3;3;2;2;2;2;2;2;2;2;3
3;3;2;2;2;2;2;2;2;2;2;2;2;3;3;3;2;2;2;2;2;2;2;2;2;3;2;2;2;2;2;2;2;2;3;3;3;3;2;2;2;2;2;3;3;2;2;3;3;3;3;3;2;2;2;3;3;3;2;2;2;2;2;2;2;2;3
3;2;2;2;2;2;2;2;2;2;2;2;2;3;3;3;2;2;2;2;2;2;2;2;2;3;2;2;2;2;2;2;33;3;3;3;3;3;2;2;2;2;2;3;3;2;2;3;3;3;3;3;2;2;2;2;3;3;2;2;2;2;2;2;2;2;3
3;2;2;2;2;2;2;2;2;2;2;2;2;2;3;3;2;2;2;2;2;2;2;2;2;3;2;2;2;2;2;3;3;3;3;3;2;2;2;2;2;2;2;2;2;2;2;2;3;3;3;3;2;2;2;2;3;3;2;2;2;2;2;2;2;2;3
3;2;2;2;2;2;2;3;3;2;2;2;2;2;3;3;2;2;2;2;2;2;2;2;2;3;2;2;2;3;3;3;3;3;3;3;2;2;2;2;2;2;2;2;2;2;2;2;3;3;3;3;2;2;2;2;2;3;2;2;2;3;3;2;2;2;3
3;2;2;2;2;2;2;3;3;3;2;2;2;2;2;3;2;2;2;2;2;2;2;2;3;3;3;2;2;2;3;3;3;3;2;2;2;2;2;2;2;2;2;2;2;2;2;2;2;3;3;3;2;2;2;2;2;3;2;2;3;3;3;3;2;2;3
3;3;3;3;2;2;2;3;3;3;2;2;2;2;2;3;2;2;2;2;2;2;2;2;3;3;3;2;2;2;2;2;33;3;2;2;2;2;2;2;2;2;2;2;2;2;2;2;2;3;3;3;2;2;2;2;2;2;2;2;3;3;3;3;2;2;3
3;3;3;3;2;2;2;2;3;3;2;2;2;2;2;2;2;2;2;2;2;2;2;3;3;3;3;2;2;2;2;2;3;3;2;2;2;2;2;2;2;2;2;2;2;2;2;2;2;3;3;3;2;2;2;2;2;2;2;2;2;3;3;3;3;3;3
3;3;3;3;3;2;2;2;2;2;2;2;2;2;2;2;2;2;2;2;2;2;3;3;3;3;3;3;2;2;2;2;2;3;2;2;2;2;2;2;2;2;2;2;2;2;2;2;2;3;2;2;2;2;2;2;2;2;2;2;2;2;2;3;3;3;3
3;3;3;3;3;2;2;2;2;2;2;2;2;2;2;2;2;2;2;2;3;3;3;3;3;3;3;3;3;2;2;2;2;2;2;2;2;2;3;3;2;2;2;2;2;2;2;2;2;3;2;2;2;2;2;2;2;2;2;2;2;2;2;2;2;3;3
3;3;3;3;2;2;2;2;2;2;2;2;2;2;2;2;2;3;3;3;3;3;3;3;3;3;3;3;3;2;2;2;2;2;2;2;2;3;3;3;3;2;2;3;3;2;2;2;2;2;2;2;2;2;2;2;2;2;2;2;2;2;2;2;2;2;3
3;3;3;3;3;2;2;2;2;2;2;2;2;2;2;2;2;3;3;3;3;3;3;3;3;3;3;3;2;2;2;2;2;2;2;2;2;3;3;3;3;2;2;3;3;2;2;2;2;2;2;2;2;2;2;2;2;2;2;2;2;2;2;2;2;2;3
3;3;3;3;3;2;2;2;2;2;2;3;3;3;3;3;3;3;3;3;3;3;3;3;3;3;3;2;2;2;2;2;2;2;2;2;2;2;3;3;3;3;3;3;3;2;2;2;2;2;2;2;2;2;2;2;2;2;2;2;2;2;2;2;2;2;3
3;3;3;3;3;2;2;2;2;2;3;3;3;3;3;3;3;3;3;3;3;2;2;2;2;2;2;2;2;2;2;2;2;2;2;2;2;2;2;2;3;3;3;3;3;2;2;2;2;2;2;2;2;2;2;2;2;3;3;2;2;2;2;2;2;2;3
3;3;3;3;3;3;3;2;2;3;3;3;3;3;3;3;3;3;3;3;2;2;2;2;2;2;2;2;2;2;2;2;3;3;2;2;2;2;2;2;2;2;3;3;2;2;2;2;2;2;2;2;2;2;2;2;3;3;3;3;2;2;3;3;2;2;3
3;3;3;3;3;3;3;2;2;3;3;3;3;2;2;2;2;2;2;2;2;2;2;2;2;2;2;2;2;3;2;2;3;3;2;2;2;2;2;2;2;2;2;2;2;2;2;2;2;2;2;2;2;2;2;2;3;3;3;3;2;2;3;3;2;2;3
3;3;3;2;2;2;2;2;2;2;3;3;2;2;2;2;2;2;2;2;2;2;2;2;2;2;2;2;3;3;2;2;2;2;2;2;2;2;2;2;2;2;2;2;2;2;2;2;2;2;3;3;2;2;2;2;2;3;3;3;3;3;3;3;2;2;3
3;3;2;2;2;2;2;2;2;2;2;2;2;2;2;2;2;2;2;2;2;2;2;2;2;2;3;3;3;3;2;2;2;2;2;2;2;2;2;2;2;2;2;2;2;2;2;2;2;2;3;3;3;2;2;2;2;2;2;3;3;3;3;3;2;2;3
3;3;2;2;2;2;2;2;2;2;2;2;2;2;2;2;2;2;2;2;2;2;3;3;3;3;3;3;3;3;2;2;2;2;2;2;2;2;2;2;2;2;2;2;2;2;2;2;2;2;3;3;3;2;2;2;2;2;2;2;2;3;3;2;2;2;3
3;3;3;2;2;2;2;2;2;2;2;2;2;2;2;2;2;2;2;3;3;3;3;3;3;3;3;3;3;3;2;2;2;2;2;2;2;3;3;2;2;2;2;3;3;2;2;2;2;2;2;3;3;2;2;2;2;2;2;2;2;2;2;2;2;2;3
3;3;3;2;2;2;2;2;2;2;2;2;2;2;3;3;3;3;3;3;3;3;3;3;3;3;3;3;3;3;3;2;2;2;2;2;2;3;3;2;2;2;2;3;3;2;2;2;2;2;2;2;2;2;2;2;2;2;2;2;2;2;2;2;2;2;3
3;3;3;3;3;3;3;3;2;2;2;2;2;2;3;3;3;3;3;3;3;3;3;2;2;2;3;3;3;3;3;3;2;2;2;2;2;2;2;2;2;2;2;2;2;2;2;2;2;2;2;2;2;2;2;2;2;2;2;2;2;2;2;2;2;2;3
3;3;3;3;3;3;3;3;2;2;2;2;2;2;3;3;3;3;3;3;3;2;2;2;2;2;3;3;3;3;3;3;3;2;2;2;2;2;2;2;2;2;2;2;2;2;2;2;2;2;2;2;2;2;2;2;2;2;2;2;2;2;2;2;2;2;3
3;3;3;3;3;3;3;2;2;2;2;2;2;2;3;3;3;3;3;3;3;2;2;2;2;2;2;3;3;3;3;3;3;3;2;2;2;2;2;2;2;2;2;2;2;2;2;2;2;2;2;2;2;2;2;2;3;3;2;2;2;2;3;3;2;2;3
3;3;3;3;3;2;2;2;2;2;2;2;2;2;2;3;3;3;3;3;3;3;3;2;2;2;2;3;3;3;3;3;3;3;2;2;2;2;2;2;2;2;2;2;2;2;2;2;2;2;2;2;2;2;3;3;3;3;2;2;2;2;3;3;2;2;3
3;3;3;3;3;2;2;2;2;2;2;2;2;2;2;2;2;3;3;3;3;3;3;2;2;2;2;3;3;3;3;3;3;3;2;2;2;2;2;2;2;2;2;2;2;2;2;2;2;2;2;2;2;3;3;3;2;2;2;2;2;2;2;2;2;2;3
3;3;3;3;3;2;2;2;2;2;2;2;2;2;2;2;2;3;3;3;2;2;2;2;2;2;2;3;2;2;2;3;2;2;2;2;2;2;2;2;3;3;2;2;2;2;2;2;2;3;2;2;3;3;3;3;2;2;2;2;2;2;2;2;2;2;3
3;3;3;3;3;2;2;2;2;2;2;2;2;2;2;2;2;3;3;3;2;2;2;2;2;2;2;3;2;2;2;2;2;2;2;2;2;2;2;2;2;2;2;2;2;2;2;2;2;2;2;2;3;3;3;3;2;2;2;2;2;2;2;2;2;2;3
3;3;3;3;3;3;2;2;2;2;2;2;2;2;2;2;2;2;3;3;2;2;2;2;2;2;2;2;2;2;2;2;2;2;2;2;2;2;3;2;2;2;2;3;2;2;2;2;2;2;2;2;2;3;3;2;2;2;2;2;2;2;2;2;2;2;3
3;3;3;3;3;3;2;2;2;2;2;2;2;2;2;2;2;2;3;2;2;2;3;2;2;2;2;2;2;2;2;2;2;2;2;2;2;2;3;2;2;2;2;3;2;2;2;2;2;2;2;2;2;2;2;2;2;2;2;2;2;2;2;2;2;2;3
3;3;3;3;3;3;3;2;2;2;2;2;3;2;2;2;2;2;2;2;2;2;3;3;2;2;2;2;2;3;2;2;2;2;2;2;2;2;2;2;2;2;2;2;2;2;2;2;2;2;2;2;2;2;2;2;2;2;2;2;2;2;2;2;2;2;3
3;3;3;3;3;3;3;2;2;2;2;2;3;2;2;2;2;2;2;2;2;3;3;3;2;2;2;2;2;2;2;2;2;2;2;2;2;2;2;2;3;3;2;2;2;2;2;2;2;3;2;2;2;2;2;3;2;2;2;2;2;2;2;2;2;2;3
3;3;3;3;3;3;3;2;2;2;2;3;3;3;2;2;2;2;2;2;2;3;3;3;2;2;2;2;2;2;2;2;2;2;2;2;2;2;2;2;2;2;2;2;2;2;2;2;2;3;2;2;2;2;2;3;2;2;2;2;2;2;2;2;2;2;3
3;3;3;3;3;3;3;3;2;2;2;3;3;3;3;3;2;2;2;2;2;2;22;2;2;2;2;2;2;2;2;2;2;2;2;3;3;3;3;3;2;2;2;2;2;2;2;2;2;3;2;2;2;2;2;2;2;3;3;2;2;2;2;2;2;2;3
3;2;2;2;2;3;3;3;2;2;2;2;2;3;3;3;2;2;2;2;2;2;2;2;2;2;2;2;2;2;2;2;2;2;3;3;3;3;3;3;2;2;2;2;2;2;2;2;2;2;2;2;2;2;2;2;3;3;3;3;2;2;3;3;2;2;3
3;3;2;2;2;3;3;3;2;2;2;2;2;3;3;3;2;2;2;2;2;2;2;2;2;2;2;2;2;2;2;2;3;3;3;3;3;3;3;3;3;2;2;2;2;2;2;2;2;2;2;2;3;2;2;3;3;3;3;3;2;2;3;3;2;2;3
3;3;2;2;2;2;3;3;2;2;2;2;2;3;3;3;2;2;2;2;2;2;2;2;2;2;2;2;2;2;2;3;3;3;3;3;3;3;3;3;3;2;2;2;2;2;2;2;2;2;2;2;2;2;2;3;2;3;3;3;3;3;3;3;2;2;3
3;3;3;2;2;2;2;2;2;2;2;2;2;2;3;3;2;2;2;2;2;2;2;2;2;2;2;2;2;2;2;3;3;3;3;3;3;3;3;3;2;2;2;2;2;2;2;2;2;2;2;2;2;2;2;2;2;2;2;3;3;3;3;3;2;2;3
3;3;3;2;2;2;2;2;2;2;2;2;2;2;3;3;2;2;2;2;2;2;2;2;2;2;2;2;2;2;2;3;3;3;3;3;3;3;3;2;2;2;2;2;2;2;2;3;2;2;2;2;2;2;2;2;2;2;2;2;2;3;3;2;2;2;3
3;3;2;2;2;2;2;2;2;2;2;2;2;2;2;3;2;2;2;3;3;2;2;2;2;2;2;2;2;2;2;3;3;2;2;2;2;2;2;2;2;2;2;2;2;2;2;3;2;2;2;2;2;2;2;2;2;2;2;2;2;2;2;2;2;2;3
3;3;3;2;2;2;2;2;2;2;2;2;2;2;2;3;2;2;3;3;3;3;2;2;3;3;2;2;2;2;2;3;2;2;2;2;2;2;2;2;2;2;2;2;3;2;3;3;3;2;2;2;2;2;2;2;2;2;2;2;2;2;2;2;2;2;3
3;3;3;2;2;2;2;2;2;3;2;2;2;2;2;2;2;2;3;3;3;3;2;2;3;3;2;2;2;2;2;2;2;2;2;2;2;2;2;2;2;3;2;2;3;2;3;3;3;3;3;2;2;2;2;2;2;2;2;2;2;2;2;2;2;2;3
3;3;3;2;2;2;2;2;3;3;2;2;2;2;2;2;2;2;2;3;3;3;3;3;3;3;2;2;2;2;2;2;2;2;2;2;2;2;2;2;3;3;2;2;2;2;2;2;3;3;3;2;2;2;2;2;2;2;2;2;2;2;2;2;2;2;3
3;3;3;3;3;2;2;3;3;3;2;2;2;2;2;2;2;2;2;2;2;3;3;3;3;3;2;2;2;2;2;2;2;2;2;2;2;2;3;3;3;3;2;2;2;2;2;2;3;3;3;2;2;2;2;2;3;3;2;2;2;2;3;3;2;2;3
3;3;3;3;3;2;2;3;3;3;2;2;2;2;2;2;2;2;2;2;2;2;2;3;3;2;2;2;2;2;2;2;2;2;3;3;3;3;3;3;3;3;2;2;2;2;2;2;3;3;3;2;2;2;2;2;3;3;2;2;2;2;3;3;2;2;3
3;2;2;2;2;2;2;2;3;3;2;2;3;3;3;2;2;2;2;2;2;2;2;2;2;2;2;2;2;2;2;2;3;3;3;3;3;3;3;3;3;3;2;2;2;2;2;2;2;3;3;2;2;2;2;2;2;2;2;2;2;2;2;2;2;2;3
3;2;2;2;2;2;2;2;2;2;2;3;3;3;3;3;3;2;2;2;2;2;2;2;2;2;2;2;2;2;2;3;3;3;3;3;3;3;3;3;3;3;3;2;2;2;2;2;2;3;3;2;2;2;2;2;2;2;2;2;2;2;2;2;2;2;3
3;2;2;2;2;2;2;2;2;2;3;3;3;3;3;3;2;2;2;2;2;2;2;2;2;2;2;2;2;2;2;2;3;3;3;2;2;2;3;3;3;3;3;3;2;2;2;2;2;2;3;2;2;2;3;3;2;2;2;2;2;3;3;2;2;2;3
3;2;2;2;2;2;2;2;2;2;3;3;3;3;3;3;2;2;2;2;2;2;2;2;2;2;2;2;2;2;2;2;2;2;2;2;2;2;3;3;3;3;3;3;3;2;2;2;2;2;3;2;2;3;3;3;3;2;2;2;2;3;3;2;2;2;3
3;2;2;2;2;2;2;2;2;2;3;3;3;2;2;2;2;2;3;3;2;2;2;2;3;3;2;2;2;2;2;2;2;2;2;2;2;2;2;3;3;3;3;3;3;2;2;2;2;2;2;2;2;3;3;3;3;2;2;2;2;2;2;2;2;2;3
3;3;3;3;3;3;2;2;2;2;3;3;2;2;2;2;2;2;3;3;2;2;2;3;3;3;3;3;2;2;2;2;2;3;3;2;2;2;2;3;3;3;3;3;3;2;2;2;2;2;2;2;2;2;3;3;3;3;3;2;2;2;2;2;2;2;3
3;3;3;3;3;3;2;2;2;2;2;2;2;2;2;2;2;2;3;3;2;2;3;3;3;3;3;3;2;2;2;2;2;3;3;2;2;2;2;3;3;3;3;3;3;2;2;2;2;2;2;2;2;3;3;3;3;3;3;2;2;2;2;2;2;2;3
3;3;3;3;3;2;2;2;2;2;2;2;2;2;2;2;2;3;3;3;3;3;3;3;3;3;3;3;2;2;2;2;2;2;2;2;2;2;3;3;3;3;3;3;3;3;3;2;2;2;2;2;2;3;3;3;3;3;3;2;2;2;2;2;2;2;3
3;3;3;3;3;3;3;3;3;3;3;3;3;3;3;3;3;3;3;3;3;3;3;3;3;3;3;3;3;3;3;3;3;3;3;3;3;3;3;3;3;3;3;3;3;3;3;3;3;3;3;3;3;3;3;3;3;3;3;3;3;3;3;3;3;3;3
